20,20,,,,,,,,,,,,,,,,,,,,,,,,,,,,,,,,,,,,,,,,,,,,,,,,,,,,,,,,,,,,,,,,,,,,,,,,,,,,,,,,,,,,,,,,,,,,,,,,,,,,,,
,,,,,,,,,,,,,,,,,,,,,,,,,,,,,,,,,,,,,,,,,,,,,,,,,,,,,,,,,,,,,,,,,,,,,,,,,,,,,,,,,,,,,,,,,,,,,,,,,,,,,,,
r,road,,,,,,,,,,,,,,,,,,,,,,,,,,,,,,,,,,,,,,,,,,,,,,,,,,,,,,,,,,,,,,,,,,,,,,,,,,,,,,,,,,,,,,,,,,,,,,,,,,,,,,
g,grass,,,,,,,,,,,,,,,,,,,,,,,,,,,,,,,,,,,,,,,,,,,,,,,,,,,,,,,,,,,,,,,,,,,,,,,,,,,,,,,,,,,,,,,,,,,,,,,,,,,,,,
,,,,,,,,,,,,,,,,,,,,,,,,,,,,,,,,,,,,,,,,,,,,,,,,,,,,,,,,,,,,,,,,,,,,,,,,,,,,,,,,,,,,,,,,,,,,,,,,,,,,,,,
r,r,r,r,r,r,r,r,r,r,r,r,r,r,r,r,r,r,r,r,r,r,r,r,r,r,r,r,r,r,r,r,r,r,r,r,r,r,r,r,r,r,r,r,r,r,r,r,r,r,r,r,r,r,r,r,r,r,r,r,r,r,r,g,g,g,g,g,g,g,g,g,g,g,g,r,r,g,g,g,g,g,g,g,r,r,g,g,g,g,g,g,g,r,r,g,g,g,g,g,g,g,g,g
r,r,r,r,r,r,r,r,r,r,r,r,r,r,r,r,r,r,r,r,r,r,r,r,r,r,r,r,r,r,r,r,r,r,r,r,r,r,r,r,r,r,r,r,r,r,r,r,r,r,r,r,r,r,r,r,r,r,r,r,r,r,r,g,g,g,g,g,g,g,g,g,g,g,g,r,r,g,g,g,g,g,g,g,r,r,g,g,g,g,g,g,g,r,r,g,g,g,g,g,g,g,g,g
g,g,g,g,g,g,g,g,g,g,g,g,g,g,g,r,r,g,g,g,g,g,g,g,g,g,g,g,g,g,g,g,g,g,g,g,g,r,g,g,g,g,g,r,r,g,g,g,g,g,g,g,g,g,g,g,g,g,g,r,r,r,r,g,g,g,g,g,g,g,g,g,g,g,g,r,r,g,g,g,g,g,g,g,r,r,g,g,g,g,g,g,g,r,r,g,g,g,g,g,g,g,g,g
g,g,g,g,g,g,g,g,g,g,g,g,g,g,g,r,r,g,g,g,g,g,g,g,g,g,g,g,g,g,g,g,g,g,g,g,g,r,g,g,g,g,g,r,r,g,g,g,g,g,g,g,g,g,g,g,g,g,g,r,r,r,r,r,r,r,r,r,r,r,r,r,r,r,r,r,r,r,r,r,r,r,r,r,r,r,r,r,r,r,r,r,r,r,r,r,r,r,r,r,r,r,r,r
g,g,g,g,g,g,g,g,g,g,g,g,g,g,g,r,r,g,g,g,g,g,g,g,g,g,g,g,g,g,g,g,g,g,g,g,g,r,g,g,g,g,g,r,r,g,g,g,g,g,g,g,g,g,g,g,g,g,g,r,r,r,r,r,r,r,r,r,r,r,r,r,r,r,r,r,r,r,r,r,r,r,r,r,r,r,r,r,r,r,r,r,r,r,r,r,r,r,r,r,r,r,r,r
g,g,g,g,g,g,g,g,g,g,g,g,g,g,g,r,r,g,g,g,g,g,g,g,g,g,g,g,g,g,g,g,g,g,g,g,g,r,r,r,r,g,g,r,r,g,g,g,g,g,g,g,g,g,g,g,g,g,g,r,r,r,r,g,g,g,g,g,g,g,g,g,g,g,g,r,r,g,g,g,g,g,g,g,r,r,g,g,g,g,g,g,g,r,r,g,g,g,g,g,g,g,g,g
g,g,g,g,g,g,g,g,g,g,g,g,g,g,g,r,r,g,g,g,g,g,g,g,g,g,g,g,g,g,g,g,g,g,g,g,g,r,r,r,r,g,g,r,r,g,g,g,g,g,g,g,g,g,g,g,g,g,g,r,r,r,r,g,g,g,g,g,g,g,g,g,g,g,g,r,r,g,g,g,g,g,g,g,r,r,g,g,g,g,g,g,g,r,r,g,g,g,g,g,g,g,g,g
g,g,g,g,g,g,g,g,g,g,g,g,g,g,g,r,r,g,g,g,g,g,g,g,g,g,g,g,g,g,g,g,g,g,g,g,g,r,r,r,r,g,g,r,r,g,g,g,g,g,g,g,g,g,g,g,g,g,g,r,r,r,r,g,g,g,g,g,g,g,g,g,g,g,g,r,r,g,g,g,g,g,g,g,r,r,g,g,g,g,g,g,g,r,r,g,g,g,g,g,g,g,g,g
g,g,g,g,g,g,g,g,g,g,g,g,g,g,g,r,r,g,g,g,g,g,g,g,g,g,g,g,g,g,g,g,g,g,g,g,g,r,g,g,g,g,g,r,r,g,g,g,g,g,g,g,g,g,g,g,g,g,g,r,r,r,r,g,g,g,g,g,g,g,g,g,g,g,g,r,r,g,g,g,g,g,g,g,r,r,g,g,g,g,g,g,g,r,r,g,g,g,g,g,g,g,g,g
g,g,g,g,g,g,g,g,g,g,g,g,g,g,g,r,r,g,g,g,g,g,g,g,g,g,g,g,g,g,g,g,g,g,g,g,g,r,g,g,g,g,g,r,r,g,g,g,g,g,g,g,g,g,g,g,g,g,g,r,r,r,r,r,r,r,r,r,r,r,r,r,r,r,r,r,r,r,r,r,r,r,r,r,r,r,r,r,r,r,r,r,r,r,r,r,r,r,r,r,r,r,r,r
r,r,r,r,r,r,r,r,r,r,r,r,r,r,r,r,r,r,r,r,r,r,r,r,r,r,r,r,r,r,r,r,r,r,r,r,r,r,r,r,r,r,r,r,r,r,r,r,r,r,r,r,r,r,r,r,r,r,r,r,r,r,r,g,g,g,g,g,g,g,g,g,g,g,g,r,r,g,g,g,g,g,g,g,r,r,g,g,g,g,g,g,g,r,r,g,g,g,g,g,g,g,g,g
r,r,r,r,r,r,r,r,r,r,r,r,r,r,r,r,r,r,r,r,r,r,r,r,r,r,r,r,r,r,r,r,r,r,r,r,r,r,r,r,r,r,r,r,r,r,r,r,r,r,r,r,r,r,r,r,r,r,r,r,r,r,r,g,g,g,g,g,g,g,g,g,g,g,g,r,r,g,g,g,g,g,g,g,r,r,g,g,g,g,g,g,g,r,r,g,g,g,g,g,g,g,g,g
g,g,g,g,g,g,g,g,g,g,g,g,g,g,g,r,r,g,g,g,g,g,g,g,g,g,g,g,g,r,r,g,g,g,g,g,g,g,g,g,g,g,g,r,r,g,g,g,g,g,g,g,g,g,g,g,g,g,g,r,r,r,r,g,g,g,g,g,g,g,g,g,g,g,g,r,r,g,g,g,g,g,g,g,r,r,g,g,g,g,g,g,g,r,r,g,g,g,g,g,g,g,g,g
g,g,g,g,g,g,g,g,g,g,g,g,g,g,g,r,r,g,g,g,g,g,g,g,g,g,g,g,g,r,r,g,g,g,g,g,g,g,g,g,g,g,g,r,r,g,g,g,g,g,g,g,g,g,g,g,g,g,g,r,r,r,r,g,g,g,g,g,g,g,g,g,g,g,g,r,r,g,g,g,g,g,g,g,r,r,g,g,g,g,g,g,g,r,r,g,g,g,g,g,g,g,g,g
g,g,g,g,g,g,g,g,g,g,g,g,g,g,g,r,r,g,g,g,g,g,g,g,g,g,g,g,g,r,r,g,g,g,g,g,g,g,g,g,g,g,g,r,r,g,g,g,g,g,g,g,g,g,g,g,g,g,g,r,r,r,r,r,r,r,r,r,r,r,r,r,r,r,r,r,r,r,r,r,r,r,r,r,r,r,r,r,r,r,r,r,r,r,r,r,r,r,r,r,r,r,r,r
g,g,g,g,g,g,g,g,g,g,g,g,g,g,g,r,r,g,g,g,g,g,g,g,g,g,g,g,g,r,r,g,g,g,g,g,g,g,g,g,g,g,g,r,r,g,g,g,g,g,g,g,g,g,g,g,g,g,g,r,r,r,r,r,r,r,r,r,r,r,r,r,r,r,r,r,r,r,r,r,r,r,r,r,r,r,r,r,r,r,r,r,r,r,r,r,r,r,r,r,r,r,r,r
g,g,g,g,g,g,g,g,g,g,g,g,g,g,g,r,r,g,g,g,g,g,g,g,g,g,g,g,g,r,r,g,g,g,g,g,g,g,g,g,g,g,g,r,r,g,g,g,g,g,g,g,g,g,g,g,g,g,g,r,r,r,r,g,g,g,g,g,g,g,g,g,g,g,g,r,r,g,g,g,g,g,g,g,r,r,g,g,g,g,g,g,g,r,r,g,g,g,g,g,g,g,g,g
g,g,g,g,g,g,g,g,g,g,g,g,g,g,g,r,r,g,g,g,g,g,g,g,g,g,g,g,g,r,r,g,g,g,g,g,g,g,g,g,g,g,g,r,r,g,g,g,g,g,g,g,g,g,g,g,g,g,g,r,r,r,r,g,g,g,g,g,g,g,g,g,g,g,g,r,r,g,g,g,g,g,g,g,r,r,g,g,g,g,g,g,g,r,r,g,g,g,g,g,g,g,g,g
g,g,g,g,g,g,g,g,g,g,g,g,g,g,g,r,r,g,g,g,g,g,g,g,g,g,g,g,g,r,r,g,g,g,g,g,g,g,g,g,g,g,g,r,r,g,g,g,g,g,g,g,g,g,g,g,g,g,g,r,r,r,r,g,g,g,g,g,g,g,g,g,g,g,g,r,r,g,g,g,g,g,g,g,r,r,g,g,g,g,g,g,g,r,r,g,g,g,g,g,g,g,g,g
g,g,g,g,g,g,g,g,g,g,g,g,g,g,g,r,r,g,g,g,g,g,g,g,g,g,g,g,g,r,r,g,g,g,g,g,g,g,g,g,g,g,g,r,r,g,g,g,g,g,g,g,g,g,g,g,g,g,g,r,r,r,r,g,g,g,g,g,g,g,g,g,g,g,g,r,r,g,g,g,g,g,g,g,r,r,g,g,g,g,g,g,g,r,r,g,g,g,g,g,g,g,g,g
r,r,r,r,r,r,r,r,r,r,r,r,r,r,r,r,r,r,r,r,r,r,r,r,r,r,r,r,r,r,r,r,r,r,r,r,r,r,r,r,r,r,r,r,r,r,r,r,r,r,r,r,r,r,r,r,r,r,r,r,r,r,r,g,g,g,g,g,g,g,g,g,g,g,g,r,r,g,g,g,g,g,g,g,r,r,g,g,g,g,g,g,g,r,r,g,g,g,g,g,g,g,g,g
r,r,r,r,r,r,r,r,r,r,r,r,r,r,r,r,r,r,r,r,r,r,r,r,r,r,r,r,r,r,r,r,r,r,r,r,r,r,r,r,r,r,r,r,r,r,r,r,r,r,r,r,r,r,r,r,r,r,r,r,r,r,r,g,g,g,g,g,g,g,g,g,g,g,g,r,r,g,g,g,g,g,g,g,r,r,g,g,g,g,g,g,g,r,r,g,g,g,g,g,g,g,g,g
g,g,g,g,g,g,g,g,g,g,g,g,g,g,g,r,r,g,g,g,g,g,g,g,g,g,g,g,g,g,g,g,g,g,g,g,g,g,g,g,g,g,g,r,r,g,g,g,g,g,g,g,g,g,g,g,g,g,g,r,r,r,r,g,g,g,g,g,g,g,g,g,g,g,g,r,r,g,g,g,g,g,g,g,r,r,g,g,g,g,g,g,g,r,r,g,g,g,g,g,g,g,g,g
g,g,g,g,g,g,g,g,g,g,g,g,g,g,g,r,r,g,g,g,g,g,g,g,g,g,g,g,g,g,g,g,g,g,g,g,g,g,g,g,g,g,g,r,r,g,g,g,g,g,g,g,g,g,g,g,g,g,g,r,r,r,r,r,r,r,r,r,r,r,r,r,r,r,r,r,r,r,r,r,r,r,r,r,r,r,r,r,r,r,r,r,r,r,r,r,r,r,r,r,r,r,r,r
g,g,g,g,g,g,g,g,g,g,g,g,g,g,g,r,r,g,g,g,g,g,g,g,g,g,g,g,g,g,g,g,g,g,g,g,g,g,g,g,g,g,g,r,r,g,g,g,g,g,g,g,g,g,g,g,g,g,g,r,r,r,r,r,r,r,r,r,r,r,r,r,r,r,r,r,r,r,r,r,r,r,r,r,r,r,r,r,r,r,r,r,r,r,r,r,r,r,r,r,r,r,r,r
g,g,g,g,g,g,g,g,g,g,g,g,g,g,g,r,r,g,g,g,g,g,g,g,g,g,g,g,g,g,g,g,g,g,g,g,g,g,g,g,g,g,g,r,r,g,g,g,g,g,g,g,g,g,g,g,g,g,g,r,r,r,r,g,g,g,g,g,g,g,g,g,g,g,g,r,r,g,g,g,g,g,g,g,r,r,g,g,g,g,g,g,g,r,r,g,g,g,g,g,g,g,g,g
g,g,g,g,g,g,g,g,g,g,g,g,g,g,g,r,r,g,g,g,g,g,g,g,g,g,g,g,g,g,g,g,g,g,g,g,g,g,g,g,g,g,g,r,r,g,g,g,g,g,g,g,g,g,g,g,g,g,g,r,r,r,r,g,g,g,g,g,g,g,g,g,g,g,g,r,r,g,g,g,g,g,g,g,r,r,g,g,g,g,g,g,g,r,r,g,g,g,g,g,g,g,g,g
g,g,g,g,g,g,g,g,g,g,g,g,g,g,g,r,r,g,g,g,g,g,g,g,g,g,g,g,g,g,g,g,g,g,g,g,g,g,g,g,g,g,g,r,r,g,g,g,g,g,g,g,g,g,g,g,g,g,g,r,r,r,r,g,g,g,g,g,g,g,g,g,g,g,g,r,r,g,g,g,g,g,g,g,r,r,g,g,g,g,g,g,g,r,r,g,g,g,g,g,g,g,g,g
g,g,g,g,g,g,g,g,g,g,g,g,g,g,g,r,r,g,g,g,g,g,g,g,g,g,g,g,g,g,g,g,g,g,g,g,g,g,g,g,g,g,g,r,r,g,g,g,g,g,g,g,g,g,g,g,g,g,g,r,r,r,r,g,g,g,g,g,g,g,g,g,g,g,g,r,r,g,g,g,g,g,g,g,r,r,g,g,g,g,g,g,g,r,r,g,g,g,g,g,g,g,g,g
g,g,g,g,g,g,g,g,g,g,g,g,g,g,g,r,r,g,g,g,g,g,g,g,g,g,g,g,g,g,g,g,g,g,g,g,g,g,g,g,g,g,g,r,r,g,g,g,g,g,g,g,g,g,g,g,g,g,g,r,r,r,r,g,g,g,g,g,g,g,g,g,g,g,g,r,r,g,g,g,g,g,g,g,r,r,g,g,g,g,g,g,g,r,r,g,g,g,g,g,g,g,g,g
r,r,r,r,r,r,r,r,r,r,r,r,r,r,r,r,r,r,r,r,r,r,r,r,r,r,r,r,r,r,r,r,r,r,r,r,r,r,r,r,r,r,r,r,r,r,r,r,r,r,r,r,r,r,r,r,r,r,r,r,r,r,r,g,g,g,g,g,g,g,g,g,g,g,g,r,r,g,g,g,g,g,g,g,r,r,g,g,g,g,g,g,g,r,r,g,g,g,g,g,g,g,g,g
r,r,r,r,r,r,r,r,r,r,r,r,r,r,r,r,r,r,r,r,r,r,r,r,r,r,r,r,r,r,r,r,r,r,r,r,r,r,r,r,r,r,r,r,r,r,r,r,r,r,r,r,r,r,r,r,r,r,r,r,r,r,r,g,g,g,g,g,g,g,g,g,g,g,g,r,r,g,g,g,g,g,g,g,r,r,g,g,g,g,g,g,g,r,r,g,g,g,g,g,g,g,g,g
g,g,g,g,g,g,g,g,g,g,g,g,g,g,g,r,r,g,g,g,g,g,g,g,g,g,g,g,g,g,g,g,g,g,g,g,g,g,g,g,g,g,g,r,r,g,g,g,g,g,g,g,g,g,g,g,g,g,g,r,r,r,r,g,g,g,g,g,g,g,g,g,g,g,g,r,r,g,g,g,g,g,g,g,r,r,g,g,g,g,g,g,g,r,r,g,g,g,g,g,g,g,g,g
g,g,g,g,g,g,g,g,g,g,g,g,g,g,g,r,r,g,g,g,g,g,g,g,g,g,g,g,g,g,g,g,g,g,g,g,g,g,g,g,g,g,g,r,r,g,g,g,g,g,g,g,g,g,g,g,g,g,g,r,r,r,r,r,r,r,r,r,r,r,r,r,r,r,r,r,r,r,r,r,r,r,r,r,r,r,r,r,r,r,r,r,r,r,r,r,r,r,r,r,r,r,r,r
g,g,g,g,g,g,g,g,g,g,g,g,g,g,g,r,r,g,g,g,g,g,g,g,g,g,g,g,g,g,g,g,g,g,g,g,g,g,g,g,g,g,g,r,r,g,g,g,g,g,g,g,g,g,g,g,g,g,g,r,r,r,r,r,r,r,r,r,r,r,r,r,r,r,r,r,r,r,r,r,r,r,r,r,r,r,r,r,r,r,r,r,r,r,r,r,r,r,r,r,r,r,r,r
g,g,g,g,g,g,g,g,g,g,g,g,g,g,g,r,r,g,g,g,g,g,g,g,g,g,g,g,g,g,g,g,g,g,g,g,g,g,g,g,g,g,g,r,r,g,g,g,g,g,g,g,g,g,g,g,g,g,g,r,r,r,r,g,g,g,g,g,g,g,g,g,g,g,g,g,g,g,g,g,g,g,g,g,r,r,g,g,g,g,g,g,g,r,r,g,g,g,g,g,g,g,g,g
g,g,g,g,g,g,g,g,g,g,g,g,g,g,g,r,r,g,g,g,g,g,g,g,g,g,g,g,g,g,g,g,g,g,g,g,g,g,g,g,g,g,g,r,r,g,g,g,g,g,g,g,g,g,g,g,g,g,g,r,r,r,r,g,g,g,g,g,g,g,g,g,g,g,g,g,g,g,g,g,g,g,g,g,r,r,g,g,g,g,g,g,g,r,r,g,g,g,g,g,g,g,g,g
g,g,g,g,g,g,g,g,g,g,g,g,g,g,g,r,r,g,g,g,g,g,g,g,g,g,g,g,g,g,g,g,g,g,g,g,g,g,g,g,g,g,g,r,r,g,g,g,g,g,g,g,g,g,g,g,g,g,g,r,r,r,r,g,g,g,g,g,g,g,g,g,g,g,g,g,g,g,g,g,g,g,g,g,r,r,g,g,g,g,g,g,g,r,r,g,g,g,g,g,g,g,g,g
g,g,g,g,g,g,g,g,g,g,g,g,g,g,g,r,r,g,g,g,g,g,g,g,g,g,g,g,g,g,g,g,g,g,g,g,g,g,g,g,g,g,g,r,r,g,g,g,g,g,g,g,g,g,g,g,g,g,g,r,r,r,r,g,g,g,g,g,g,g,g,g,g,g,g,g,g,g,g,g,g,g,g,g,r,r,g,g,g,g,g,g,g,r,r,g,g,g,g,g,g,g,g,g
g,g,g,g,g,g,g,g,g,g,g,g,g,g,g,r,r,g,g,g,g,g,g,g,g,g,g,g,g,g,g,g,g,g,g,g,g,g,g,g,g,g,g,r,r,g,g,g,g,g,g,g,g,g,g,g,g,g,g,r,r,r,r,g,g,g,g,g,g,g,g,g,g,g,g,g,g,g,g,g,g,g,g,g,r,r,g,g,g,g,g,g,g,r,r,g,g,g,g,g,g,g,g,g
r,r,r,r,r,r,r,r,r,r,r,r,r,r,r,r,r,r,r,r,r,r,r,r,r,r,r,r,r,r,r,r,r,r,r,r,r,r,r,r,r,r,r,r,r,r,r,r,r,r,r,r,r,r,r,r,r,r,r,r,r,r,r,r,r,r,r,r,r,r,r,r,r,r,r,r,r,r,r,r,r,r,r,r,r,r,r,r,r,r,r,r,r,r,r,r,r,r,r,r,r,r,r,r
r,r,r,r,r,r,r,r,r,r,r,r,r,r,r,r,r,r,r,r,r,r,r,r,r,r,r,r,r,r,r,r,r,r,r,r,r,r,r,r,r,r,r,r,r,r,r,r,r,r,r,r,r,r,r,r,r,r,r,r,r,r,r,r,r,r,r,r,r,r,r,r,r,r,r,r,r,r,r,r,r,r,r,r,r,r,r,r,r,r,r,r,r,r,r,r,r,r,r,r,r,r,r,r
r,r,r,r,r,r,r,r,r,r,r,r,r,r,r,r,r,r,r,r,r,r,r,r,r,r,r,r,r,r,r,r,r,r,r,r,r,r,r,r,r,r,r,r,r,r,r,r,r,r,r,r,r,r,r,r,r,r,r,r,r,r,r,r,r,r,r,r,r,r,r,r,r,r,r,r,r,r,r,r,r,r,r,r,r,r,r,r,r,r,r,r,r,r,r,r,r,r,r,r,r,r,r,r
r,r,r,r,r,r,r,r,r,r,r,r,r,r,r,r,r,r,r,r,r,r,r,r,r,r,r,r,r,r,r,r,r,r,r,r,r,r,r,r,r,r,r,r,r,r,r,r,r,r,r,r,r,r,r,r,r,r,r,r,r,r,r,r,r,r,r,r,r,r,r,r,r,r,r,r,r,r,r,r,r,r,r,r,r,r,r,r,r,r,r,r,r,r,r,r,r,r,r,r,r,r,r,r
g,g,g,g,g,g,g,g,r,r,g,g,g,g,g,g,g,g,g,r,r,g,g,g,g,g,g,g,g,g,g,g,g,g,g,r,r,g,g,g,g,g,g,g,g,g,g,g,g,g,g,g,g,g,g,g,g,g,g,r,r,r,r,g,g,g,g,g,g,g,g,r,r,g,g,g,g,g,g,g,g,r,r,g,g,g,g,g,g,g,g,g,g,r,r,g,g,g,g,g,g,g,g,g
g,g,g,g,g,g,g,g,r,r,g,g,g,g,g,g,g,g,g,r,r,g,g,g,g,g,g,g,g,g,g,g,g,g,g,r,r,g,g,g,g,g,g,g,g,g,g,g,g,g,g,g,g,g,g,g,g,g,g,r,r,r,r,g,g,g,g,g,g,g,g,r,r,g,g,g,g,g,g,g,g,r,r,g,g,g,g,g,g,g,g,g,g,r,r,g,g,g,g,g,g,g,g,g
g,g,g,g,g,g,g,g,r,r,g,g,g,g,g,g,g,g,g,r,r,g,g,g,g,g,g,g,g,g,g,g,g,g,g,r,r,g,g,g,g,g,g,g,g,g,g,g,g,g,g,g,g,g,g,g,g,g,g,r,r,r,r,g,g,g,g,g,g,g,g,r,r,g,g,g,g,g,g,g,g,r,r,g,g,g,g,g,g,g,g,g,g,r,r,g,g,g,g,g,g,g,g,g
g,g,g,g,g,g,g,g,r,r,g,g,g,g,g,g,g,g,g,r,r,g,g,g,g,g,g,g,g,g,g,g,g,g,g,r,r,g,g,g,g,g,g,g,g,g,g,g,g,g,g,g,g,g,g,g,g,g,g,r,r,r,r,g,g,g,g,g,g,g,g,r,r,g,g,g,g,g,g,g,g,r,r,g,g,g,g,g,g,g,g,g,g,r,r,g,g,g,g,g,g,g,g,g
g,g,g,g,g,g,g,g,r,r,g,g,g,g,g,g,g,g,g,r,r,g,g,g,g,g,g,g,g,g,g,g,g,g,g,r,r,g,g,g,g,g,g,g,g,g,g,g,g,g,g,g,g,g,g,g,g,g,g,r,r,r,r,g,g,g,g,g,g,g,g,r,r,g,g,g,g,g,g,g,g,r,r,g,g,g,g,g,g,g,g,g,g,r,r,g,g,g,g,g,g,g,g,g
g,g,g,g,g,g,g,g,r,r,g,g,g,g,g,g,g,g,g,r,r,g,g,g,g,g,g,g,g,g,g,g,g,g,g,r,r,g,g,g,g,g,g,g,g,g,g,g,g,g,g,g,g,g,g,g,g,g,g,r,r,r,r,g,g,g,g,g,g,g,g,r,r,g,g,g,g,g,g,g,g,r,r,g,g,g,g,g,g,g,g,g,g,r,r,g,g,g,g,g,g,g,g,g
g,g,g,g,g,g,g,g,r,r,g,g,g,g,g,g,g,g,g,r,r,g,g,g,g,g,g,g,g,g,g,g,g,g,g,r,r,r,r,r,r,r,r,r,r,r,r,r,r,r,r,r,r,r,r,r,r,r,r,r,r,r,r,g,g,g,g,g,g,g,g,r,r,g,g,g,g,g,g,g,g,r,r,g,g,g,g,g,g,g,g,g,g,r,r,g,g,g,g,g,g,g,g,g
g,g,g,g,g,g,g,g,r,r,g,g,g,g,g,g,g,g,g,r,r,g,g,g,g,g,g,g,g,g,g,g,g,g,g,r,r,r,r,r,r,r,r,r,r,r,r,r,r,r,r,r,r,r,r,r,r,r,r,r,r,r,r,g,g,g,g,g,g,g,g,r,r,g,g,g,g,g,g,g,g,r,r,g,g,g,g,g,g,g,g,g,g,r,r,g,g,g,g,g,g,g,g,g
g,g,g,g,g,g,g,g,r,r,g,g,g,g,g,g,g,g,g,r,r,g,g,g,g,g,g,g,g,g,g,g,g,g,g,r,r,g,g,g,g,g,g,g,g,g,g,g,g,g,g,g,g,g,g,g,g,g,g,r,r,r,r,g,g,g,g,g,g,g,g,r,r,g,g,g,g,g,g,g,g,r,r,g,g,g,g,g,g,g,g,g,g,r,r,g,g,g,g,g,g,g,g,g
g,g,g,g,g,g,g,g,r,r,g,g,g,g,g,g,g,g,g,r,r,g,g,g,g,g,g,g,g,g,g,g,g,g,g,r,r,g,g,g,g,g,g,g,g,g,g,g,g,g,g,g,g,g,g,g,g,g,g,r,r,r,r,g,g,g,g,g,g,g,g,r,r,g,g,g,g,g,g,g,g,r,r,g,g,g,g,g,g,g,g,g,g,r,r,g,g,g,g,g,g,g,g,g
g,g,g,g,g,g,g,g,r,r,g,g,g,g,g,g,g,g,g,r,r,g,g,g,g,g,g,g,g,g,g,g,g,g,g,r,r,g,g,g,g,g,g,g,g,g,g,g,g,g,g,g,g,g,g,g,g,g,g,r,r,r,r,g,g,g,g,g,g,g,g,r,r,g,g,g,g,g,g,g,g,r,r,g,g,g,g,g,g,g,g,g,g,r,r,g,g,g,g,g,g,g,g,g
g,g,g,g,g,g,g,g,r,r,g,g,g,g,g,g,g,g,g,r,r,g,g,g,g,g,g,g,g,g,g,g,g,g,g,r,r,g,g,g,g,g,g,g,g,g,g,g,g,g,g,g,g,g,g,g,g,g,g,r,r,r,r,g,g,g,g,g,g,g,g,r,r,g,g,g,g,g,g,g,g,r,r,g,g,g,g,g,g,g,g,g,g,r,r,g,g,g,g,g,g,g,g,g
g,g,g,g,g,g,g,g,r,r,g,g,g,g,g,g,g,g,g,r,r,g,g,g,g,g,g,g,g,g,g,g,g,g,g,r,r,g,g,g,g,g,g,g,g,g,g,g,g,g,g,g,g,g,g,g,g,g,g,r,r,r,r,g,g,g,g,g,g,g,g,r,r,g,g,g,g,g,g,g,g,r,r,g,g,g,g,g,g,g,g,g,g,r,r,g,g,g,g,g,g,g,g,g
g,g,g,g,g,g,g,g,r,r,g,g,g,g,g,g,g,g,g,r,r,g,g,g,g,g,g,g,g,g,g,g,g,g,g,r,r,g,g,g,g,g,g,g,g,g,g,g,g,g,g,g,g,g,g,g,g,g,g,r,r,r,r,r,r,r,r,r,r,r,r,r,r,r,r,r,r,r,r,r,r,r,r,r,r,r,r,r,r,r,r,r,r,r,r,r,r,r,r,r,r,r,r,r
g,g,g,g,g,g,g,g,r,r,g,g,g,g,g,g,g,g,g,r,r,g,g,g,g,g,g,g,g,g,g,g,g,g,g,r,r,g,g,g,g,g,g,g,g,g,g,g,g,g,g,g,g,g,g,g,g,g,g,r,r,r,r,r,r,r,r,r,r,r,r,r,r,r,r,r,r,r,r,r,r,r,r,r,r,r,r,r,r,r,r,r,r,r,r,r,r,r,r,r,r,r,r,r
g,g,g,g,g,g,g,g,r,r,g,g,g,g,g,g,g,g,g,r,r,g,g,g,g,g,g,g,g,g,g,g,g,g,g,r,r,g,g,g,g,g,g,g,g,g,g,g,g,g,g,g,g,g,g,g,g,g,g,r,r,r,r,g,g,g,g,g,g,g,g,r,r,g,g,g,g,r,g,g,g,g,r,g,g,g,g,r,g,g,g,g,r,g,g,g,g,g,r,g,g,g,g,g
g,g,g,g,g,g,g,g,r,r,g,g,g,g,g,g,g,g,g,r,r,g,g,g,g,g,g,g,g,g,g,g,g,g,g,r,r,g,g,g,g,g,g,g,g,g,g,g,g,g,g,g,g,g,g,g,g,g,g,r,r,r,r,g,g,g,g,g,g,g,g,r,r,g,g,g,g,r,g,g,g,g,r,g,g,g,g,r,g,g,g,g,r,g,g,g,g,g,r,g,g,g,g,g
g,g,g,g,g,g,g,g,r,r,g,g,g,g,g,g,g,g,g,r,r,g,g,g,g,g,g,g,g,g,g,g,g,g,g,r,r,g,g,g,g,g,g,g,g,g,g,g,g,g,g,g,g,g,g,g,g,g,g,r,r,r,r,g,g,g,g,g,g,g,g,r,r,g,g,g,g,r,g,g,g,g,r,g,g,g,g,r,g,g,g,g,r,g,g,g,g,g,r,g,g,g,g,g
g,g,g,g,g,g,g,g,r,r,g,g,g,g,g,g,g,g,g,r,r,r,r,r,r,r,r,r,r,r,r,r,r,r,r,r,r,r,r,r,r,r,r,r,r,r,r,r,r,r,r,r,r,r,r,r,r,r,r,r,r,r,r,g,g,g,g,g,g,g,g,r,r,g,g,g,g,r,g,g,g,g,r,g,g,g,g,r,g,g,g,g,r,g,g,g,g,g,r,g,g,g,g,g
g,g,g,g,g,g,g,g,r,r,g,g,g,g,g,g,g,g,g,r,r,r,r,r,r,r,r,r,r,r,r,r,r,r,r,r,r,r,r,r,r,r,r,r,r,r,r,r,r,r,r,r,r,r,r,r,r,r,r,r,r,r,r,g,g,g,g,g,g,g,g,r,r,r,r,r,r,r,r,r,r,r,r,r,r,r,r,r,r,r,r,r,r,r,r,r,r,r,r,r,r,r,r,r
g,g,g,g,g,g,g,g,r,r,g,g,g,g,g,g,g,g,g,r,r,g,g,g,g,g,g,g,g,g,g,r,g,g,g,g,g,g,g,g,g,g,g,g,g,r,r,g,g,g,g,g,g,g,g,g,g,g,g,r,r,r,r,g,g,g,g,g,g,g,g,r,r,g,g,g,g,r,g,g,g,g,r,g,g,g,g,r,g,g,g,g,r,g,g,g,g,g,r,g,g,g,g,g
r,r,r,r,r,r,r,r,r,r,r,r,r,r,r,r,r,r,r,r,r,g,g,g,g,g,g,g,g,g,g,r,g,g,g,g,g,g,g,g,g,g,g,g,g,r,r,g,g,g,g,g,g,g,g,g,g,g,g,r,r,r,r,g,g,g,g,g,g,g,g,r,r,g,g,g,g,r,g,g,g,g,r,g,g,g,g,r,g,g,g,g,r,g,g,g,g,g,r,g,g,g,g,g
r,r,r,r,r,r,r,r,r,r,r,r,r,r,r,r,r,r,r,r,r,g,g,g,g,g,g,g,g,g,g,r,g,g,g,g,g,g,g,g,g,g,g,g,g,r,r,g,g,g,g,g,g,g,g,g,g,g,g,r,r,r,r,g,g,g,g,g,g,g,g,r,r,g,g,g,g,r,g,g,g,g,r,g,g,g,g,r,g,g,g,g,r,g,g,g,g,g,r,g,g,g,g,g
g,g,g,g,g,g,g,g,g,g,g,g,g,g,g,g,g,g,g,r,r,g,g,g,g,g,g,g,g,g,g,r,g,g,g,g,g,g,g,g,g,g,g,g,g,r,r,g,g,g,g,g,g,g,g,g,g,g,g,r,r,r,r,g,g,g,g,g,g,g,g,r,r,g,g,g,g,r,g,g,g,g,r,g,g,g,g,r,g,g,g,g,r,g,g,g,g,g,r,g,g,g,g,g
g,g,g,g,g,g,g,g,g,g,g,g,g,g,g,g,g,g,g,r,r,g,g,g,g,g,g,g,g,g,g,r,g,g,g,g,g,g,g,g,g,g,g,g,g,r,r,g,g,g,g,g,g,g,g,g,g,g,g,r,r,r,r,g,g,g,g,g,g,g,g,r,r,g,g,g,g,r,g,g,g,g,r,g,g,g,g,r,g,g,g,g,r,g,g,g,g,g,r,g,g,g,g,g
g,g,g,g,g,g,g,g,g,g,g,g,g,g,g,g,g,g,g,r,r,g,g,g,g,g,g,g,g,g,g,r,g,g,g,g,g,g,g,g,g,g,g,g,g,r,r,g,g,g,g,g,g,g,g,g,g,g,g,r,r,r,r,g,g,g,g,g,g,g,g,r,r,g,g,g,g,r,g,g,g,g,r,g,g,g,g,r,g,g,g,g,r,g,g,g,g,g,r,g,g,g,g,g
g,g,g,g,g,g,g,g,g,g,g,g,g,g,g,g,g,g,g,r,r,g,g,g,g,g,g,g,g,g,g,r,g,g,g,g,g,g,g,g,g,g,g,g,g,r,r,g,g,g,g,g,g,g,g,g,g,g,g,r,r,r,r,g,g,g,g,g,g,g,g,r,r,g,g,g,g,r,g,g,g,g,r,g,g,g,g,r,g,g,g,g,r,g,g,g,g,g,r,g,g,g,g,g
g,g,g,g,g,g,g,g,g,g,g,g,g,g,g,g,g,g,g,r,r,g,g,g,g,g,g,g,g,g,g,r,g,g,g,g,g,g,g,g,g,g,g,g,g,r,r,g,g,g,g,g,g,g,g,g,g,g,g,r,r,r,r,g,g,g,g,g,g,g,g,r,r,g,g,g,g,r,g,g,g,g,r,g,g,g,g,r,g,g,g,g,r,g,g,g,g,g,r,g,g,g,g,g
g,g,g,g,g,g,g,g,g,g,g,g,g,g,g,g,g,g,g,r,r,g,g,g,g,g,g,g,g,g,g,r,g,g,g,g,g,g,g,g,g,g,g,g,g,r,r,g,g,g,g,g,g,g,g,g,g,g,g,r,r,r,r,g,g,g,g,g,g,g,g,r,r,g,g,g,g,r,g,g,g,g,r,g,g,g,g,r,g,g,g,g,r,g,g,g,g,g,r,g,g,g,g,g
g,g,g,g,g,g,g,g,g,g,g,g,g,g,g,g,g,g,g,r,r,g,g,g,g,g,g,g,g,g,g,r,g,g,g,g,g,g,g,g,g,g,g,g,g,r,r,g,g,g,g,g,g,g,g,g,g,g,g,r,r,r,r,g,g,g,g,g,g,g,g,r,r,r,r,r,r,r,r,r,r,r,r,r,r,r,r,r,r,r,r,r,r,r,r,r,r,r,r,r,r,r,r,r
g,g,g,g,g,g,g,g,g,g,g,g,g,g,g,g,g,g,g,r,r,g,g,g,g,g,g,g,g,g,g,r,g,g,g,g,g,g,g,g,g,g,g,g,g,r,r,g,g,g,g,g,g,g,g,g,g,g,g,r,r,r,r,g,g,g,g,g,g,g,g,r,r,g,g,g,g,r,g,g,g,g,r,g,g,g,g,r,g,g,g,g,r,g,g,g,g,g,r,g,g,g,g,g
r,r,r,r,r,r,r,r,r,r,r,r,r,r,r,r,r,r,r,r,r,g,g,g,g,g,g,g,g,g,g,r,g,g,g,g,g,g,g,g,g,g,g,g,g,r,r,g,g,g,g,g,g,g,g,g,g,g,g,r,r,r,r,g,g,g,g,g,g,g,g,r,r,g,g,g,g,r,g,g,g,g,r,g,g,g,g,r,g,g,g,g,r,g,g,g,g,g,r,g,g,g,g,g
r,r,r,r,r,r,r,r,r,r,r,r,r,r,r,r,r,r,r,r,r,g,g,g,g,g,g,g,g,g,g,r,g,g,g,g,g,g,g,g,g,g,g,g,g,r,r,g,g,g,g,g,g,g,g,g,g,g,g,r,r,r,r,g,g,g,g,g,g,g,g,r,r,g,g,g,g,r,g,g,g,g,r,g,g,g,g,r,g,g,g,g,r,g,g,g,g,g,r,g,g,g,g,g
g,g,g,g,r,r,g,g,g,g,g,g,g,g,g,g,g,g,g,g,g,g,g,g,g,g,g,g,g,g,g,r,g,g,g,g,g,g,g,g,g,g,g,g,g,r,r,r,r,r,r,r,r,r,r,r,r,r,r,r,r,r,r,r,r,r,r,r,r,r,r,r,r,g,g,g,g,r,g,g,g,g,r,g,g,g,g,r,g,g,g,g,r,g,g,g,g,g,r,g,g,g,g,g
g,g,g,g,r,r,g,g,g,g,g,g,g,g,g,g,g,g,g,g,g,g,g,g,g,g,g,g,g,g,g,r,g,g,g,g,g,g,g,g,g,g,g,g,g,r,r,r,r,r,r,r,r,r,r,r,r,r,r,r,r,r,r,r,r,r,r,r,r,r,r,r,r,g,g,g,g,r,g,g,g,g,r,g,g,g,g,r,g,g,g,g,r,g,g,g,g,g,r,g,g,g,g,g
g,g,g,g,r,r,g,g,g,g,g,g,g,g,g,g,g,g,g,g,g,g,g,g,g,g,g,g,g,g,g,r,r,r,r,r,r,r,r,r,g,g,g,g,g,r,r,g,g,g,g,g,g,g,g,g,g,g,g,r,r,r,r,g,g,g,g,g,g,g,g,r,r,g,g,g,g,r,g,g,g,g,r,g,g,g,g,r,g,g,g,g,r,g,g,g,g,g,r,g,g,g,g,g
g,g,g,g,r,r,g,g,g,g,g,g,g,g,g,g,g,g,g,g,g,g,g,g,g,g,g,g,g,g,g,r,g,g,g,g,g,g,g,g,g,g,g,g,g,r,r,g,g,g,g,g,g,g,g,g,g,g,g,r,r,r,r,g,g,g,g,g,g,g,g,r,r,g,g,g,g,r,g,g,g,g,r,g,g,g,g,r,g,g,g,g,r,g,g,g,g,g,r,g,g,g,g,g
g,g,g,g,r,r,g,g,g,g,g,g,g,g,g,g,g,g,g,g,g,g,g,g,g,g,g,g,g,g,g,r,g,g,g,g,g,g,g,g,g,g,g,g,g,r,r,g,g,g,g,g,g,g,g,g,g,g,g,r,r,r,r,g,g,g,g,g,g,g,g,r,r,g,g,g,g,r,g,g,g,g,r,g,g,g,g,r,g,g,g,g,r,g,g,g,g,g,r,g,g,g,g,g
g,g,g,g,r,r,g,g,g,g,g,g,g,g,g,g,g,g,g,g,g,g,g,g,g,g,g,g,g,g,g,r,g,g,g,g,g,g,g,g,g,g,g,g,g,r,r,g,g,g,g,g,g,g,g,g,g,g,g,r,r,r,r,g,g,g,g,g,g,g,g,r,r,g,g,g,g,r,g,g,g,g,r,g,g,g,g,r,g,g,g,g,r,g,g,g,g,g,r,g,g,g,g,g
g,g,g,g,r,r,g,g,g,g,g,g,g,g,g,g,g,g,g,g,g,g,g,g,g,g,g,g,g,g,g,r,g,g,g,g,g,g,g,g,g,g,g,g,g,r,r,g,g,g,g,g,g,g,g,g,g,g,g,r,r,r,r,g,g,g,g,g,g,g,g,r,r,r,r,r,r,r,r,r,r,r,r,r,r,r,r,r,r,r,r,r,r,r,r,r,r,r,r,r,r,r,r,r
g,g,g,g,r,r,g,g,g,g,g,g,g,g,g,g,g,g,g,g,g,g,g,g,g,g,g,g,g,g,g,r,g,g,g,g,g,g,g,g,g,g,g,g,g,r,r,g,g,g,g,g,g,g,g,g,g,g,g,r,r,r,r,g,g,g,g,g,g,g,g,r,r,g,g,g,g,r,g,g,g,g,r,g,g,g,g,r,g,g,g,g,r,g,g,g,g,g,r,g,g,g,g,g
g,g,g,g,r,r,g,g,g,g,g,g,g,g,g,g,g,g,g,g,g,g,g,g,g,g,g,g,g,g,g,r,g,g,g,g,g,g,g,g,g,g,g,g,g,r,r,g,g,g,g,g,g,g,g,g,g,g,g,r,r,r,r,g,g,g,g,g,g,g,g,r,r,g,g,g,g,r,g,g,g,g,r,g,g,g,g,r,g,g,g,g,r,g,g,g,g,g,r,g,g,g,g,g
g,g,g,g,r,r,g,g,g,g,g,g,g,g,g,g,g,g,g,g,g,g,g,g,g,g,g,g,g,g,g,r,g,g,g,g,g,g,g,g,g,g,g,g,g,r,r,g,g,g,g,g,g,g,g,g,g,g,g,r,r,r,r,g,g,g,g,g,g,g,g,r,r,g,g,g,g,r,g,g,g,g,r,g,g,g,g,r,g,g,g,g,r,g,g,g,g,g,r,g,g,g,g,g
g,g,g,g,r,r,g,g,g,g,g,g,g,g,g,g,g,g,g,g,g,g,g,g,g,g,g,g,g,g,g,r,g,g,g,g,g,g,g,g,g,g,g,g,g,r,r,g,g,g,g,g,g,g,g,g,g,g,g,r,r,r,r,g,g,g,g,g,g,g,g,r,r,g,g,g,g,r,g,g,g,g,r,g,g,g,g,r,g,g,g,g,r,g,g,g,g,g,r,g,g,g,g,g
g,g,g,g,r,r,g,g,g,g,g,g,g,g,g,g,g,g,g,g,g,g,g,g,g,g,g,g,g,g,g,r,g,g,g,g,g,g,g,g,g,g,g,g,g,r,r,r,r,r,r,r,r,r,r,r,r,r,r,r,r,r,r,g,g,g,g,g,g,g,g,r,r,g,g,g,g,r,g,g,g,g,r,g,g,g,g,r,g,g,g,g,r,g,g,g,g,g,r,g,g,g,g,g
g,g,g,g,r,r,g,g,g,g,g,g,g,g,g,g,g,g,g,g,g,g,g,g,g,g,g,g,g,g,g,r,g,g,g,g,g,g,g,g,g,g,g,g,g,r,r,g,g,g,g,g,g,g,g,g,g,g,g,r,r,r,r,g,g,g,g,g,g,g,g,r,r,g,g,g,g,r,g,g,g,g,r,g,g,g,g,r,g,g,g,g,r,g,g,g,g,g,r,g,g,g,g,g
g,g,g,g,r,r,g,g,g,g,g,g,g,g,g,g,g,g,g,g,g,g,g,g,g,g,g,g,g,g,g,r,g,g,g,g,g,g,g,g,g,g,g,g,g,r,r,g,g,g,g,g,g,g,g,g,g,g,g,r,r,r,r,g,g,g,g,g,g,g,g,r,r,g,g,g,g,r,g,g,g,g,r,g,g,g,g,r,g,g,g,g,r,g,g,g,g,g,r,g,g,g,g,g
g,g,g,g,r,r,r,r,r,r,r,r,r,r,r,r,r,r,r,r,r,r,r,r,r,r,r,r,r,r,r,r,r,r,r,r,r,r,r,r,r,r,r,r,r,r,r,g,g,g,g,g,g,g,g,g,g,g,g,r,r,r,r,g,g,g,g,g,g,g,g,r,r,g,g,g,g,r,g,g,g,g,r,g,g,g,g,r,g,g,g,g,r,g,g,g,g,g,r,g,g,g,g,g
g,g,g,g,r,r,r,r,r,r,r,r,r,r,r,r,r,r,r,r,r,r,r,r,r,r,r,r,r,r,r,r,r,r,r,r,r,r,r,r,r,r,r,r,r,r,r,g,g,g,g,g,g,g,g,g,g,g,g,r,r,r,r,r,r,r,r,r,r,r,r,r,r,g,g,g,g,r,g,g,g,g,r,g,g,g,g,r,g,g,g,g,r,g,g,g,g,g,r,g,g,g,g,g
g,g,g,g,r,r,g,g,g,g,g,g,g,g,g,g,g,g,g,g,g,g,g,g,g,g,g,g,g,g,g,g,g,g,g,r,r,g,g,g,g,g,g,g,g,g,g,g,g,g,g,g,g,g,g,g,g,g,g,r,r,r,r,r,r,r,r,r,r,r,r,r,r,g,g,g,g,r,g,g,g,g,r,g,g,g,g,r,g,g,g,g,r,g,g,g,g,g,r,g,g,g,g,g
g,g,g,g,r,r,g,g,g,g,g,g,g,g,g,g,g,g,g,g,g,g,g,g,g,g,g,g,g,g,g,g,g,g,g,r,r,g,g,g,g,g,g,g,g,g,g,g,g,g,g,g,g,g,g,g,g,g,g,r,r,r,r,g,g,g,g,g,g,g,g,r,r,r,r,r,r,r,r,r,r,r,r,r,r,r,r,r,r,r,r,r,r,r,r,r,r,r,r,r,r,r,r,r
g,g,g,g,r,r,g,g,g,g,g,g,g,g,g,g,g,g,g,g,g,g,g,g,g,g,g,g,g,g,g,g,g,g,g,r,r,g,g,g,g,g,g,g,g,g,g,g,g,g,g,g,g,g,g,g,g,g,g,r,r,r,r,g,g,g,g,g,g,g,g,r,r,g,g,g,g,r,g,g,g,g,r,g,g,g,g,r,g,g,g,g,r,g,g,g,g,g,r,g,g,g,g,g
g,g,g,g,r,r,g,g,g,g,g,g,g,g,g,g,g,g,g,g,g,g,g,g,g,g,g,g,g,g,g,g,g,g,g,r,r,g,g,g,g,g,g,g,g,g,g,g,g,g,g,g,g,g,g,g,g,g,g,r,r,r,r,g,g,g,g,g,g,g,g,r,r,g,g,g,g,r,g,g,g,g,r,g,g,g,g,r,g,g,g,g,r,g,g,g,g,g,r,g,g,g,g,g
g,g,g,g,r,r,g,g,g,g,g,g,g,g,g,g,g,g,g,g,g,g,g,g,g,g,g,g,g,g,g,g,g,g,g,r,r,g,g,g,g,g,g,g,g,g,g,g,g,g,g,g,g,g,g,g,g,g,g,r,r,r,r,g,g,g,g,g,g,g,g,r,r,g,g,g,g,r,g,g,g,g,r,g,g,g,g,r,g,g,g,g,r,g,g,g,g,g,r,g,g,g,g,g
g,g,g,g,r,r,g,g,g,g,g,g,g,g,g,g,g,g,g,g,g,g,g,g,g,g,g,g,g,g,g,g,g,g,g,r,r,g,g,g,g,g,g,g,g,g,g,g,g,g,g,g,g,g,g,g,g,g,g,r,r,r,r,g,g,g,g,g,g,g,g,r,r,g,g,g,g,r,g,g,g,g,r,g,g,g,g,r,g,g,g,g,r,g,g,g,g,g,r,g,g,g,g,g
g,g,g,g,r,r,g,g,g,g,g,g,g,g,g,g,g,g,g,g,g,g,g,g,g,g,g,g,g,g,g,g,g,g,g,r,r,g,g,g,g,g,g,g,g,g,g,g,g,g,g,g,g,g,g,g,g,g,g,r,r,r,r,g,g,g,g,g,g,g,g,r,r,g,g,g,g,r,g,g,g,g,r,g,g,g,g,r,g,g,g,g,r,g,g,g,g,g,r,g,g,g,g,g
